NO ./path_to_the_north_texture 
SO ./path_to_the_south_texture 
EA ./path_to_the_east_texture 
WE ./path_to_the_west_texture

F 270,100,0
C 225,30,0


11111111111111
10001000000001
11111111111111
11111111111111
10000000E00001
11111111111111
10001000000001
11111111111111
11111111111111
10000000000001
11111111111111