NO ./assets/textures/wall4.xpm
SO ./assets/textures/wall4.xpm
EA ./assets/textures/wall4.xpm
WE ./assets/textures/barrel.png

F 0,211,1
C 225,0,0


11111111111111111111111
10001000000001111111111
11111111111111111111111
11111111111111111111111
11111111111111111111111
10000000E00001111111111
11111111111111111111111
10001000000001111111111
11111111111111111111111
11111111111111111111111
10000000000001111111111
11111111111111111111111