NO ./path_to_the_north_texture 
SO ./path_to_the_south_texture 
EA ./path_to_the_east_texture 
WE ./path_to_the_west_texture

F 220,100,0
C 225,30,0

11111111111111
100010    0001
1111         
1    1111    1
1  00000000001
11111111111111