NO
WE
SO
AE

F
C

1111111111
1111010001
1111010111
1111010001
1111011111
1110100001
1000010001
1111111111