NO ./path_to_the_north_texture 
SO ./path_to_the_south_texture 
EA ./path_to_the_east_texture 
WE ./path_to_the_west_texture

F 220,100,0
C 225,30,0

        111111111111111111111111111
        100000000110110000000000001
        101100000111110000000000001
        100100000110000000000000001
1111111110110000011110000000000001
1000000000110000011110111111111111
111101111111110111100000010001
111101111111110111101010010001
110000001101010111100000010001
100000000000000011100000010001
100000000000000011101010010001
1100000111010101111101110N111
11110111 1110101 101111010001
11111111 1111111 111111111111