NO ./path_to_the_north_texture 
SO ./path_to_the_south_texture 
EA ./path_to_the_east_texture 
WE ./path_to_the_west_texture

F 220,100,0
C 225,30,0

        1111111111	11111111111111111
        1000000001	10110000000000001
        1011000001	11110000000000001
        1001000001	10000000000000001
111111111011000001	1110000000000001
100000000011000001	1110111111111111
111101111111110111	100000010001
111101111111110111	101010010001
110000001101010111	100000010001
100000000000000011	100000010001
100000000000000011	101010010001
110000011101010111	11011110N0111
11110111 1110101 	101111010001
11111111 1111111 	111111111111