11111111111111
100010    0001
1111         
1    1111    1
1  00000000001
11111111111111