NO ./path_to_the_north_texture 
SO ./path_to_the_south_texture 
EA ./path_to_the_east_texture 
WE ./path_to_the_west_texture

F 220,100,0
C 225,30,0


1111111111
 1010010001
1011010111
 1000010001
1111011101
 1001000001
10W0010001
 1111111111


