NO ./assets/textures/wall1.xpm
SO ./assets/textures/wall2.xpm
EA ./assets/textures/wall3.xpm
WE ./assets/textures/wall4.xpm

F 100,100,100
C 152,152,152

        1111111111111111111111111
        1000000000110000000000001
        1011000001110000000000001
        100100000000000000N000001
111111111011000001100000000000001
100000000011000001101111111111111
1111011111111101100000010001
1111011111111101101010010001
1100000011010101100000010001
1000000000000000100000010001
1000000000000000101010010001
11000001110101011101111000111
11110111 1110101 101111010001
11111111 1111111 111111111111