SO ./assets/textures/wall1.xpm
NO ./assets/textures/wall2.xpm
EA ./assets/textures/wall3.xpm
WE ./assets/textures/bluestone.xpm

F 220,100,0
C 255,30,0


1111111111
1110000001
1110001111
1111001111
1000N01111
1111001111
1111001111
1111000001
1111111111