NO ./path_to_the_north_texture 
SO ./path_to_the_south_texture 
EA ./path_to_the_east_texture 
WE ./path_to_the_west_texture

F 220,100,0
C 225,30,0


1111111111
1000000001
1111001111
1111001111
1111N01111
1111001111
1111001111
1111000001
1111111111